22222222222222222222222222
20000000000000000000000002
20333333333333333333333302
20300000000000030000500302
20300000000000030005050302
20300300333333339393553302
20300300000300030000050302
20333500000300000000000302
20305553333300030000300302
20305000300000033300300302
20300300300000000000300302
20300300000300000000308302
20333333333399933333333302
20000000000000000000000002
22222222222222222222222222