22222222222222
20000000000002
20777777777702
20708000000702
20700000000702
20700000000702
20700000000702
20700000000702
20777777777702
20000000000002
22222222222222