222222222222222222222
200000000000000000002
207777777777777777702
207000000070000000702
207000000070000080702
207000777770005550702
207000000000000550702
207055000000005550702
207005000000000000702
207777777777777777702
200000000000000000002
222222222222222222222