22222222222222222222
20000000000000000002
20777777777777777702
20708700000000000702
20700700000000000702
20770777000777777702
20700755000700000702
20700755000000000702
20700700000000000702
20700700000000700702
20700777777777700702
20700007000000000702
20700007000000000702
20700777000777777702
20700000000000000702
20700000000000000702
20700000000000000702
20777777777777777702
20000000000000000002
22222222222222222222