22222222222222222222222222222222222222222
20000000000000000000000000000000000000002
20666666666666666666666666669696966666602
20611111111111111119611611115555111111902
20611111111111111119611611151111511111602
20611666666116666696611966661111166666602
20611611116511111611911111116111111111902
20666611111151111111611116666111111111602
20611111111115611111611161111116611111902
20611111666666666666611168116111611111602
20611111111111116111111666666511666611602
20611116111111116111111161151511111111602
20611666661161116111611161115111111111602
20611911166661116515611166666666611611602
20611911111111111555611111116111111611602
20611611111111111511611111111111111699602
20666666666666666666669996666666666666602
20000000000000000000000000000000000000002
22222222222222222222222222222222222222222